16 30
0 2 9 3 1 1 1 2 4 9 3 9 3 3 9 9 3 9 1 0 0 0 0 0 0 1 2 9 1 0 
1 3 9 3 9 2 2 9 9 9 4 3 9 9 4 4 9 3 1 0 0 0 1 1 1 1 9 2 1 0 
9 2 1 2 2 9 3 4 6 9 2 2 9 9 3 3 9 2 0 0 0 1 2 9 1 1 1 1 1 1 
1 2 1 1 1 1 2 9 9 2 1 1 2 2 2 9 2 1 0 1 2 3 9 3 2 1 0 0 1 9 
1 2 9 2 1 1 1 2 2 1 0 0 0 0 1 1 1 0 0 1 9 9 3 4 9 2 1 1 2 1 
9 3 1 3 9 2 0 1 1 1 0 0 0 0 0 0 0 0 0 1 3 4 9 4 9 3 3 9 2 0 
9 3 1 2 9 2 0 1 9 1 1 2 2 1 0 0 0 0 0 0 1 9 4 9 3 9 3 9 2 0 
2 9 2 2 1 1 1 2 3 2 3 9 9 2 1 0 0 0 0 0 1 2 9 2 2 1 2 1 1 0 
1 2 9 2 1 0 1 9 2 9 3 9 5 9 1 0 1 1 1 0 0 1 1 1 0 0 0 0 0 0 
0 1 2 9 1 0 2 2 4 2 3 2 9 4 4 2 2 9 1 1 1 1 1 1 1 0 0 0 0 0 
2 3 3 2 1 0 1 9 2 9 1 1 3 9 9 9 2 1 2 3 9 3 2 9 1 0 0 0 1 1 
9 9 9 1 1 1 2 2 3 2 1 0 2 9 5 3 2 1 2 9 9 9 2 1 1 0 0 0 1 9 
2 4 3 2 1 9 1 1 9 2 1 0 1 1 2 9 2 3 9 4 4 3 2 1 1 2 1 1 2 2 
1 2 9 2 2 3 2 2 2 9 1 1 1 1 2 3 9 4 9 3 2 9 1 1 9 3 9 2 1 9 
9 3 3 4 9 2 9 2 2 3 2 3 9 3 2 9 3 9 9 9 9 2 1 1 1 4 9 3 1 1 
1 2 9 9 2 2 1 2 9 2 9 3 9 9 2 1 2 9 9 9 9 1 0 0 0 2 9 2 0 0 
